Job,ID,DagmanID,Node IP,SUBMIT,EXECUTE,JOB_TERMINATED,JOB_SUCCESS,POST_SCRIPT_STARTED,POST_SCRIPT_TERMINATED,POST_SCRIPT_SUCCESS,wait_time,exec_time,ps_time
mDiffFit,ID0000441,10241.000.000,192.168.1.161,1611580985,1611581056,1611581058,1611581059,1611581059,1611581060,1611581065,71,3,6
mDiffFit,ID0000433,10323.000.000,192.168.1.161,1611584436,1611584486,1611584499,1611584500,1611584500,1611584500,1611584505,50,14,5
mDiffFit,ID0000093,10471.000.000,192.168.1.161,1611589960,1611590071,1611590076,1611590082,1611590082,1611590082,1611590087,111,11,5
mBackground,ID0000144,10654.000.000,192.168.1.161,1611592509,1611592527,1611592540,1611592543,1611592543,1611592543,1611592549,18,16,6
mDiffFit,ID0000107,10413.000.000,192.168.1.161,1611588130,1611588207,1611588208,1611588208,1611588208,1611588208,1611588213,77,1,5
mBackground,ID0000297,10540.000.000,192.168.1.161,1611591096,1611591138,1611591147,1611591152,1611591152,1611591152,1611591157,42,14,5
register_local,1_1,10623.000.000,192.168.1.4,1611592351,1611592352,1611592354,1611592358,1611592358,1611592358,1611592364,1,6,6
mDiffFit,ID0000414,10515.000.000,192.168.1.161,1611590474,1611590574,1611590575,1611590579,1611590579,1611590579,1611590584,100,5,5
stage_in_remote_local,0_7,10136.000.000,192.168.1.4,1611573074,1611573078,1611573080,1611573085,1611573085,1611573085,1611573091,4,7,6
stage_in_remote_local,0_3,10140.000.000,192.168.1.4,1611573079,1611573081,1611573086,1611573091,1611573091,1611573091,1611573097,2,10,6
mDiffFit,ID0000084,10285.000.000,192.168.1.161,1611582759,1611582850,1611582857,1611582860,1611582860,1611582860,1611582865,91,10,5
mDiffFit,ID0000228,10347.000.000,192.168.1.161,1611585645,1611585728,1611585742,1611585743,1611585743,1611585743,1611585748,83,15,5
register_local,29_1,10642.000.000,192.168.1.4,1611592424,1611592428,1611592432,1611592437,1611592437,1611592438,1611592445,4,9,8
mDiffFit,ID0000128,10595.000.000,192.168.1.161,1611592070,1611592192,1611592194,1611592196,1611592196,1611592196,1611592201,122,4,5
mViewer,ID0000472,10697.000.000,192.168.1.161,1611592775,1611592801,1611592847,1611592847,1611592847,1611592847,1611592852,26,46,5
mDiffFit,ID0000193,10230.000.000,192.168.1.161,1611579447,1611579467,1611579478,1611579484,1611579484,1611579485,1611579490,20,17,6
mDiffFit,ID0000253,10221.000.000,192.168.1.161,1611579358,1611579377,1611579383,1611579384,1611579384,1611579384,1611579389,19,7,5
mDiffFit,ID0000121,10363.000.000,192.168.1.161,1611586258,1611586338,1611586339,1611586342,1611586342,1611586342,1611586348,80,4,6
mDiffFit,ID0000043,10295.000.000,192.168.1.161,1611583945,1611583981,1611583982,1611583987,1611583987,1611583987,1611583992,36,6,5
mDiffFit,ID0000349,10571.000.000,192.168.1.161,1611591889,1611591967,1611591980,1611591980,1611591980,1611591980,1611591985,78,13,5
mDiffFit,ID0000417,10442.000.000,192.168.1.161,1611588699,1611588820,1611588829,1611588829,1611588829,1611588830,1611588834,121,9,5
mBackground,ID0000309,10551.000.000,192.168.1.161,1611591110,1611591279,1611591290,1611591293,1611591293,1611591294,1611591299,169,14,6
mProject,ID0000015,10187.000.000,192.168.1.161,1611573424,1611586366,1611588101,1611588106,1611588106,1611588106,1611588111,12942,1740,5
mBackground,ID0000150,10669.000.000,192.168.1.161,1611592533,1611592645,1611592655,1611592661,1611592661,1611592661,1611592666,112,16,5
mDiffFit,ID0000113,10292.000.000,192.168.1.161,1611583944,1611583950,1611583956,1611583961,1611583961,1611583961,1611583966,6,11,5
mDiffFit,ID0000227,10335.000.000,192.168.1.161,1611585248,1611585657,1611585660,1611585664,1611585664,1611585664,1611585669,409,7,5
mDiffFit,ID0000401,10570.000.000,192.168.1.161,1611591887,1611591959,1611591961,1611591963,1611591963,1611591963,1611591968,72,4,5
mDiffFit,ID0000040,10235.000.000,192.168.1.161,1611579876,1611579897,1611579899,1611579903,1611579903,1611579903,1611579908,21,6,5
mDiffFit,ID0000413,10213.000.000,192.168.1.161,1611578119,1611578142,1611578144,1611578144,1611578144,1611578144,1611578149,23,2,5
mDiffFit,ID0000363,10263.000.000,192.168.1.161,1611581450,1611581540,1611581550,1611581552,1611581552,1611581552,1611581557,90,12,5
mDiffFit,ID0000446,10239.000.000,192.168.1.161,1611580985,1611581042,1611581043,1611581048,1611581048,1611581048,1611581053,57,6,5
stage_in_remote_local,3_4,10149.000.000,192.168.1.4,1611573097,1611573099,1611573102,1611573103,1611573103,1611573103,1611573108,2,4,5
mBackground,ID0000149,10659.000.000,192.168.1.161,1611592516,1611592575,1611592596,1611592597,1611592597,1611592599,1611592604,59,22,7
mDiffFit,ID0000131,10298.000.000,192.168.1.161,1611583951,1611584002,1611584008,1611584012,1611584012,1611584013,1611584018,51,10,6
clean_up_local_level,0_10,10699.000.000,192.168.1.4,1611592857,1611592857,1611592871,1611592872,1611592872,1611592873,1611592878,0,15,6
mBackground,ID0000143,10656.000.000,192.168.1.161,1611592510,1611592543,1611592566,1611592571,1611592571,1611592573,1611592578,33,28,7
mDiffFit,ID0000440,10508.000.000,192.168.1.161,1611590467,1611590510,1611590516,1611590516,1611590516,1611590517,1611590522,43,6,6
mDiffFit,ID0000341,10437.000.000,192.168.1.161,1611588688,1611588788,1611588790,1611588793,1611588793,1611588794,1611588799,100,5,6
mDiffFit,ID0000261,10526.000.000,192.168.1.161,1611590907,1611590998,1611591004,1611591009,1611591009,1611591009,1611591014,91,11,5
mDiffFit,ID0000442,10324.000.000,192.168.1.161,1611584439,1611584486,1611584488,1611584490,1611584490,1611584490,1611584495,47,4,5
register_local,34_1,10611.000.000,192.168.1.4,1611592228,1611592231,1611592237,1611592241,1611592241,1611592241,1611592246,3,10,5
mDiffFit,ID0000449,10503.000.000,192.168.1.161,1611590460,1611590474,1611590475,1611590480,1611590480,1611590480,1611590485,14,6,5
register_local,18_1,10671.000.000,192.168.1.4,1611592555,1611592556,1611592559,1611592560,1611592560,1611592564,1611592571,1,4,11
mDiffFit,ID0000044,10411.000.000,192.168.1.161,1611588124,1611588189,1611588190,1611588193,1611588193,1611588193,1611588198,65,4,5
register_local,28_1,10670.000.000,192.168.1.4,1611592541,1611592543,1611592548,1611592549,1611592549,1611592549,1611592555,2,6,6
mDiffFit,ID0000178,10367.000.000,192.168.1.161,1611586904,1611586915,1611586923,1611586930,1611586930,1611586930,1611586939,11,15,9
mDiffFit,ID0000104,10605.000.000,192.168.1.161,1611592095,1611592260,1611592270,1611592277,1611592277,1611592277,1611592282,165,17,5
mDiffFit,ID0000439,10441.000.000,192.168.1.161,1611588697,1611588814,1611588826,1611588829,1611588829,1611588829,1611588834,117,15,5
mDiffFit,ID0000092,10480.000.000,192.168.1.161,1611589973,1611590123,1611590135,1611590135,1611590135,1611590137,1611590141,150,12,6
mBackground,ID0000299,10537.000.000,192.168.1.161,1611591096,1611591099,1611591109,1611591110,1611591110,1611591110,1611591115,3,11,5
stage_in_remote_local,0_6,10137.000.000,192.168.1.4,1611573079,1611573082,1611573087,1611573091,1611573091,1611573091,1611573097,3,9,6
mDiffFit,ID0000365,10420.000.000,192.168.1.161,1611588657,1611588691,1611588694,1611588702,1611588702,1611588702,1611588710,34,11,8
mDiffFit,ID0000373,10342.000.000,192.168.1.161,1611585601,1611585700,1611585704,1611585704,1611585704,1611585705,1611585710,99,4,6
mDiffFit,ID0000360,10339.000.000,192.168.1.161,1611585595,1611585682,1611585693,1611585698,1611585698,1611585699,1611585704,87,16,6
mDiffFit,ID0000424,10445.000.000,192.168.1.161,1611588708,1611588845,1611588848,1611588853,1611588853,1611588856,1611588861,137,8,8
mDiffFit,ID0000240,10525.000.000,192.168.1.161,1611590902,1611590990,1611590991,1611590992,1611590992,1611590992,1611590997,88,2,5
mDiffFit,ID0000237,10270.000.000,192.168.1.161,1611582356,1611582399,1611582400,1611582404,1611582404,1611582405,1611582410,43,5,6
mDiffFit,ID0000251,10279.000.000,192.168.1.161,1611582642,1611582787,1611582794,1611582797,1611582797,1611582798,1611582803,145,10,6
mProject,ID0000162,10174.000.000,192.168.1.161,1611573330,1611581238,1611582342,1611582344,1611582344,1611582345,1611582350,7908,1106,6
mBgModel,ID0000295,10536.000.000,192.168.1.161,1611591075,1611591075,1611591083,1611591085,1611591085,1611591085,1611591090,0,10,5
mDiffFit,ID0000416,10304.000.000,192.168.1.161,1611584069,1611584107,1611584108,1611584110,1611584110,1611584111,1611584116,38,3,6
mDiffFit,ID0000101,10289.000.000,192.168.1.161,1611582759,1611582883,1611582885,1611582886,1611582886,1611582887,1611582892,124,3,6
mDiffFit,ID0000293,10330.000.000,192.168.1.161,1611585242,1611585614,1611585620,1611585623,1611585623,1611585624,1611585629,372,9,6
mDiffFit,ID0000053,10634.000.000,192.168.1.161,1611592364,1611592428,1611592431,1611592432,1611592432,1611592432,1611592437,64,4,5
mProject,ID0000173,10181.000.000,192.168.1.161,1611573417,1611584144,1611585227,1611585231,1611585231,1611585231,1611585236,10727,1087,5
register_local,12_1,10498.000.000,192.168.1.4,1611590081,1611590082,1611590084,1611590087,1611590087,1611590088,1611590093,1,5,6
mDiffFit,ID0000243,10379.000.000,192.168.1.161,1611586922,1611586992,1611587002,1611587009,1611587009,1611587010,1611587015,70,17,6
mDiffFit,ID0000332,10434.000.000,192.168.1.161,1611588681,1611588777,1611588779,1611588782,1611588782,1611588782,1611588787,96,5,5
mDiffFit,ID0000409,10452.000.000,192.168.1.161,1611588716,1611588887,1611588898,1611588899,1611588899,1611588899,1611588904,171,12,5
register_local,24_1,10533.000.000,192.168.1.4,1611590960,1611590961,1611590963,1611590965,1611590965,1611590966,1611590971,1,4,6
mDiffFit,ID0000038,10287.000.000,192.168.1.161,1611582759,1611582869,1611582871,1611582875,1611582875,1611582875,1611582880,110,6,5
mDiffFit,ID0000432,10246.000.000,192.168.1.161,1611581037,1611581101,1611581107,1611581111,1611581111,1611581111,1611581116,64,10,5
mBackground,ID0000140,10667.000.000,192.168.1.161,1611592532,1611592614,1611592639,1611592646,1611592646,1611592647,1611592652,82,32,6
mDiffFit,ID0000396,10572.000.000,192.168.1.161,1611591889,1611591971,1611591982,1611591985,1611591985,1611591986,1611591991,82,14,6
mDiffFit,ID0000127,10606.000.000,192.168.1.161,1611592095,1611592261,1611592265,1611592270,1611592270,1611592272,1611592277,166,9,7
mDiffFit,ID0000174,10374.000.000,192.168.1.161,1611586915,1611586959,1611586972,1611586983,1611586983,1611586983,1611586994,44,24,11
mDiffFit,ID0000445,10318.000.000,192.168.1.161,1611584425,1611584451,1611584462,1611584468,1611584468,1611584469,1611584474,26,17,6
mDiffFit,ID0000197,10386.000.000,192.168.1.161,1611586929,1611587032,1611587034,1611587037,1611587037,1611587038,1611587042,103,5,5
mDiffFit,ID0000263,10529.000.000,192.168.1.161,1611590908,1611591028,1611591029,1611591034,1611591034,1611591034,1611591039,120,6,5
mBackground,ID0000304,10550.000.000,192.168.1.161,1611591110,1611591267,1611591276,1611591278,1611591278,1611591278,1611591283,157,11,5
mDiffFit,ID0000361,10259.000.000,192.168.1.161,1611581444,1611581505,1611581506,1611581510,1611581510,1611581510,1611581515,61,5,5
mDiffFit,ID0000218,10219.000.000,192.168.1.161,1611578337,1611579359,1611579364,1611579364,1611579364,1611579365,1611579369,1022,5,5
mConcatFit,ID0000137,10647.000.000,192.168.1.161,1611592473,1611592474,1611592477,1611592478,1611592478,1611592478,1611592483,1,4,5
mDiffFit,ID0000427,10416.000.000,192.168.1.161,1611588655,1611588666,1611588674,1611588681,1611588681,1611588682,1611588691,11,15,10
mDiffFit,ID0000262,10524.000.000,192.168.1.161,1611590902,1611590983,1611590984,1611590987,1611590987,1611590987,1611590992,81,4,5
mDiffFit,ID0000189,10492.000.000,192.168.1.161,1611590033,1611590198,1611590213,1611590215,1611590215,1611590216,1611590224,165,17,9
mDiffFit,ID0000239,10351.000.000,192.168.1.161,1611585648,1611585755,1611585766,1611585768,1611585768,1611585768,1611585773,107,13,5
mDiffFit,ID0000428,10421.000.000,192.168.1.161,1611588663,1611588698,1611588702,1611588710,1611588710,1611588711,1611588716,35,12,6
register_local,11_1,10499.000.000,192.168.1.4,1611590124,1611590125,1611590127,1611590130,1611590130,1611590130,1611590135,1,5,5
mProject,ID0000319,10162.000.000,192.168.1.161,1611573316,1611576627,1611578172,1611578174,1611578174,1611578175,1611578179,3311,1547,5
mDiffFit,ID0000028,10399.000.000,192.168.1.161,1611587001,1611587109,1611587111,1611587111,1611587111,1611587112,1611587116,108,2,5
mDiffFit,ID0000196,10281.000.000,192.168.1.161,1611582642,1611582807,1611582808,1611582808,1611582808,1611582808,1611582813,165,1,5
mDiffFit,ID0000336,10439.000.000,192.168.1.161,1611588689,1611588798,1611588800,1611588804,1611588804,1611588804,1611588809,109,6,5
mDiffFit,ID0000129,10594.000.000,192.168.1.161,1611592068,1611592172,1611592181,1611592183,1611592183,1611592184,1611592189,104,11,6
register_local,2_0,10256.000.000,192.168.1.4,1611581252,1611581257,1611581259,1611581263,1611581263,1611581263,1611581268,5,6,5
mDiffFit,ID0000404,10559.000.000,192.168.1.161,1611591863,1611591881,1611591882,1611591891,1611591891,1611591892,1611591897,18,10,6
mDiffFit,ID0000277,10277.000.000,192.168.1.161,1611582641,1611582765,1611582770,1611582770,1611582770,1611582770,1611582775,124,5,5
mDiffFit,ID0000059,10317.000.000,192.168.1.161,1611584370,1611584444,1611584448,1611584450,1611584450,1611584451,1611584456,74,6,6
mDiffFit,ID0000281,10387.000.000,192.168.1.161,1611586936,1611587043,1611587054,1611587055,1611587055,1611587055,1611587060,107,12,5
stage_out_local_local,0_6,10695.000.000,192.168.1.4,1611592774,1611592780,1611592798,1611592801,1611592801,1611592802,1611592807,6,21,6
mDiffFit,ID0000207,10518.000.000,192.168.1.161,1611590896,1611590927,1611590933,1611590934,1611590934,1611590934,1611590939,31,7,5
mDiffFit,ID0000245,10460.000.000,192.168.1.161,1611589743,1611589993,1611589995,1611589996,1611589996,1611589996,1611590001,250,3,5
mDiffFit,ID0000420,10319.000.000,192.168.1.161,1611584425,1611584456,1611584458,1611584461,1611584461,1611584463,1611584468,31,5,7
register_local,19_1,10610.000.000,192.168.1.4,1611592207,1611592209,1611592211,1611592214,1611592214,1611592216,1611592220,2,5,6
mDiffFit,ID0000275,10463.000.000,192.168.1.161,1611589743,1611590016,1611590023,1611590024,1611590024,1611590024,1611590033,273,8,9
mDiffFit,ID0000355,10199.000.000,192.168.1.161,1611574888,1611574896,1611574897,1611574899,1611574899,1611574899,1611574904,8,3,5
stage_in_local_local,4_0,10150.000.000,192.168.1.4,1611573097,1611573099,1611573315,1611573317,1611573317,1611573317,1611573324,2,218,7
mDiffFit,ID0000082,10470.000.000,192.168.1.161,1611589959,1611590059,1611590070,1611590071,1611590071,1611590071,1611590076,100,12,5
register_local,35_1,10693.000.000,192.168.1.4,1611592753,1611592754,1611592756,1611592759,1611592759,1611592759,1611592764,1,5,5
mImgtbl,ID0000155,10685.000.000,192.168.1.161,1611592672,1611592692,1611592694,1611592697,1611592697,1611592697,1611592702,20,5,5
mDiffFit,ID0000125,10410.000.000,192.168.1.161,1611588124,1611588174,1611588183,1611588183,1611588183,1611588184,1611588188,50,9,5
mDiffFit,ID0000021,10394.000.000,192.168.1.161,1611586990,1611587079,1611587089,1611587094,1611587094,1611587095,1611587100,89,15,6
mDiffFit,ID0000335,10562.000.000,192.168.1.161,1611591869,1611591902,1611591911,1611591914,1611591914,1611591915,1611591920,33,12,6
mProject,ID0000008,10153.000.000,192.168.1.161,1611573303,1611573316,1611575044,1611575044,1611575044,1611575044,1611575049,13,1728,5
mProject,ID0000011,10164.000.000,192.168.1.161,1611573317,1611577691,1611579414,1611579415,1611579415,1611579415,1611579420,4374,1724,5
mDiffFit,ID0000205,10486.000.000,192.168.1.161,1611590024,1611590159,1611590167,1611590169,1611590169,1611590170,1611590175,135,10,6
mDiffFit,ID0000408,10249.000.000,192.168.1.161,1611581043,1611581126,1611581133,1611581136,1611581136,1611581136,1611581141,83,10,5
mDiffFit,ID0000423,10423.000.000,192.168.1.161,1611588665,1611588709,1611588720,1611588721,1611588721,1611588721,1611588726,44,12,5
mDiffFit,ID0000187,10370.000.000,192.168.1.161,1611586905,1611586935,1611586939,1611586945,1611586945,1611586946,1611586951,30,10,6
mProject,ID0000328,10179.000.000,192.168.1.161,1611573417,1611582908,1611584412,1611584414,1611584414,1611584415,1611584420,9491,1506,6
mDiffFit,ID0000182,10371.000.000,192.168.1.161,1611586905,1611586940,1611586943,1611586945,1611586945,1611586946,1611586951,35,5,6
clean_up_local_level,0_7,10683.000.000,192.168.1.4,1611592671,1611592671,1611592689,1611592691,1611592691,1611592692,1611592697,0,20,6
mDiffFit,ID0000087,10601.000.000,192.168.1.161,1611592077,1611592221,1611592225,1611592229,1611592229,1611592231,1611592235,144,8,6
stage_in_remote_local,2_1,10147.000.000,192.168.1.4,1611573091,1611573096,1611573098,1611573103,1611573103,1611573103,1611573108,5,7,5
mDiffFit,ID0000241,10356.000.000,192.168.1.161,1611585658,1611585793,1611585800,1611585800,1611585800,1611585801,1611585806,135,7,6
mDiffFit,ID0000387,10303.000.000,192.168.1.161,1611584069,1611584100,1611584101,1611584105,1611584105,1611584106,1611584110,31,5,5
mDiffFit,ID0000435,10505.000.000,192.168.1.161,1611590460,1611590489,1611590490,1611590495,1611590495,1611590495,1611590500,29,6,5
mDiffFit,ID0000188,10369.000.000,192.168.1.161,1611586905,1611586929,1611586933,1611586939,1611586939,1611586940,1611586945,24,10,6
mDiffFit,ID0000124,10294.000.000,192.168.1.161,1611583945,1611583969,1611583975,1611583977,1611583977,1611583977,1611583982,24,8,5
register_local,0_0,10639.000.000,192.168.1.4,1611592382,1611592385,1611592390,1611592397,1611592397,1611592398,1611592404,3,12,7
mDiffFit,ID0000119,10358.000.000,192.168.1.161,1611586252,1611586273,1611586282,1611586285,1611586285,1611586286,1611586291,21,12,6
register_local,0_1,10612.000.000,192.168.1.4,1611592246,1611592246,1611592254,1611592257,1611592257,1611592258,1611592265,0,11,8
clean_up_local_level,1_3,10593.000.000,192.168.1.4,1611592067,1611592067,1611592080,1611592088,1611592088,1611592088,1611592096,0,21,8
mBackground,ID0000153,10658.000.000,192.168.1.161,1611592515,1611592547,1611592567,1611592571,1611592571,1611592574,1611592578,32,24,7
mDiffFit,ID0000425,10424.000.000,192.168.1.161,1611588667,1611588723,1611588727,1611588731,1611588731,1611588732,1611588737,56,8,6
mDiffFit,ID0000364,10301.000.000,192.168.1.161,1611584068,1611584081,1611584087,1611584090,1611584090,1611584090,1611584095,13,9,5
mBgModel,ID0000138,10650.000.000,192.168.1.161,1611592488,1611592489,1611592496,1611592499,1611592499,1611592499,1611592504,1,10,5
mDiffFit,ID0000069,10415.000.000,192.168.1.161,1611588131,1611588220,1611588222,1611588224,1611588224,1611588224,1611588229,89,4,5
mDiffFit,ID0000222,10388.000.000,192.168.1.161,1611586938,1611587043,1611587045,1611587049,1611587049,1611587050,1611587055,105,6,6
clean_up_local_level,6_7,10676.000.000,192.168.1.4,1611592621,1611592626,1611592640,1611592647,1611592647,1611592647,1611592652,5,21,5
mDiffFit,ID0000029,10390.000.000,192.168.1.161,1611586978,1611587054,1611587057,1611587060,1611587060,1611587062,1611587066,76,6,6
mDiffFit,ID0000353,10248.000.000,192.168.1.161,1611581037,1611581119,1611581121,1611581126,1611581126,1611581126,1611581131,82,7,5
mBackground,ID0000310,10538.000.000,192.168.1.161,1611591096,1611591113,1611591122,1611591126,1611591126,1611591126,1611591131,17,13,5
mDiffFit,ID0000106,10297.000.000,192.168.1.161,1611583950,1611583994,1611583996,1611583997,1611583997,1611583997,1611584002,44,3,5
mDiffFit,ID0000407,10426.000.000,192.168.1.161,1611588672,1611588734,1611588738,1611588743,1611588743,1611588744,1611588749,62,9,6
mDiffFit,ID0000055,10638.000.000,192.168.1.161,1611592375,1611592447,1611592449,1611592451,1611592451,1611592451,1611592457,72,4,6
mDiffFit,ID0000346,10262.000.000,192.168.1.161,1611581450,1611581525,1611581535,1611581536,1611581536,1611581537,1611581542,75,11,6
mDiffFit,ID0000070,10255.000.000,192.168.1.161,1611581252,1611581484,1611581485,1611581488,1611581488,1611581489,1611581494,232,4,6
mDiffFit,ID0000334,10431.000.000,192.168.1.161,1611588679,1611588756,1611588769,1611588771,1611588771,1611588771,1611588776,77,15,5
mProject,ID0000010,10183.000.000,192.168.1.161,1611573418,1611584504,1611586238,1611586241,1611586241,1611586241,1611586246,11086,1737,5
mDiffFit,ID0000184,10373.000.000,192.168.1.161,1611586913,1611586951,1611586954,1611586957,1611586957,1611586957,1611586962,38,6,5
mDiffFit,ID0000091,10250.000.000,192.168.1.161,1611581246,1611581444,1611581445,1611581451,1611581451,1611581451,1611581456,198,7,5
mDiffFit,ID0000097,10481.000.000,192.168.1.161,1611589973,1611590136,1611590140,1611590141,1611590141,1611590142,1611590148,163,5,7
mDiffFit,ID0000210,10493.000.000,192.168.1.161,1611590040,1611590205,1611590207,1611590209,1611590209,1611590210,1611590215,165,4,6
mProject,ID0000329,10161.000.000,192.168.1.161,1611573316,1611576577,1611578107,1611578108,1611578108,1611578108,1611578113,3261,1531,5
mDiffFit,ID0000052,10635.000.000,192.168.1.161,1611592364,1611592429,1611592431,1611592437,1611592437,1611592438,1611592445,65,8,8
clean_up_local_level,9_7,10681.000.000,192.168.1.4,1611592659,1611592659,1611592674,1611592679,1611592679,1611592680,1611592685,0,20,6
mDiffFit,ID0000072,10478.000.000,192.168.1.161,1611589967,1611590112,1611590113,1611590114,1611590114,1611590114,1611590119,145,2,5
mDiffFit,ID0000264,10522.000.000,192.168.1.161,1611590901,1611590968,1611590970,1611590971,1611590971,1611590971,1611590976,67,3,5
mDiffFit,ID0000135,10296.000.000,192.168.1.161,1611583945,1611583988,1611583989,1611583992,1611583992,1611583992,1611583997,43,4,5
mDiffFit,ID0000071,10310.000.000,192.168.1.161,1611584363,1611584392,1611584402,1611584406,1611584406,1611584409,1611584414,29,14,8
mProject,ID0000320,10197.000.000,192.168.1.161,1611573476,1611590237,1611591851,1611591852,1611591852,1611591852,1611591857,16761,1615,5
mProject,ID0000006,10160.000.000,192.168.1.161,1611573315,1611575955,1611577637,1611577641,1611577641,1611577641,1611577646,2640,1686,5
mDiffFit,ID0000042,10237.000.000,192.168.1.161,1611579877,1611579912,1611579913,1611579914,1611579914,1611579914,1611579919,35,2,5
mDiffFit,ID0000266,10284.000.000,192.168.1.161,1611582648,1611582836,1611582845,1611582850,1611582850,1611582850,1611582855,188,14,5
mDiffFit,ID0000383,10341.000.000,192.168.1.161,1611585595,1611585696,1611585700,1611585704,1611585704,1611585705,1611585710,101,8,6
clean_up_local_level,7_3,10621.000.000,192.168.1.4,1611592351,1611592352,1611592363,1611592364,1611592364,1611592364,1611592376,1,12,12
mDiffFit,ID0000049,10625.000.000,192.168.1.161,1611592351,1611592379,1611592396,1611592404,1611592404,1611592406,1611592411,28,25,7
mDiffFit,ID0000372,10512.000.000,192.168.1.161,1611590473,1611590548,1611590549,1611590549,1611590549,1611590550,1611590554,75,1,5
mDiffFit,ID0000410,10204.000.000,192.168.1.161,1611576603,1611576609,1611576615,1611576618,1611576618,1611576619,1611576624,6,9,6
mBackground,ID0000141,10665.000.000,192.168.1.161,1611592524,1611592614,1611592640,1611592647,1611592647,1611592647,1611592652,90,33,5
cleanup_montage,local_0,10703.000.000,192.168.1.4,1611592899,1611592899,1611592901,1611592904,1611592904,1611592904,1611592909,0,5,5
mDiffFit,ID0000095,10477.000.000,192.168.1.161,1611589966,1611590103,1611590116,1611590119,1611590119,1611590119,1611590124,137,16,5
mDiffFit,ID0000034,10312.000.000,192.168.1.161,1611584364,1611584418,1611584424,1611584430,1611584430,1611584431,1611584440,54,12,10
mDiffFit,ID0000282,10382.000.000,192.168.1.161,1611586927,1611587009,1611587024,1611587026,1611587026,1611587026,1611587031,82,17,5
mProject,ID0000001,10184.000.000,192.168.1.161,1611573423,1611585228,1611586966,1611586967,1611586967,1611586968,1611586972,11805,1739,5
mProject,ID0000323,10188.000.000,192.168.1.161,1611573424,1611587109,1611588641,1611588644,1611588644,1611588644,1611588649,13685,1535,5
mDiffFit,ID0000219,10530.000.000,192.168.1.161,1611590908,1611591035,1611591041,1611591044,1611591044,1611591044,1611591049,127,9,5
mProject,ID0000322,10177.000.000,192.168.1.161,1611573336,1611582512,1611584054,1611584058,1611584058,1611584058,1611584063,9176,1546,5
mDiffFit,ID0000183,10383.000.000,192.168.1.161,1611586929,1611587017,1611587020,1611587021,1611587021,1611587021,1611587026,88,4,5
mProject,ID0000324,10169.000.000,192.168.1.161,1611573324,1611579485,1611581024,1611581026,1611581026,1611581026,1611581031,6161,1541,5
mDiffFit,ID0000415,10418.000.000,192.168.1.161,1611588656,1611588680,1611588681,1611588681,1611588681,1611588682,1611588691,24,1,10
mDiffFit,ID0000103,10226.000.000,192.168.1.161,1611579425,1611579446,1611579456,1611579456,1611579456,1611579457,1611579461,21,10,5
mDiffFit,ID0000083,10208.000.000,192.168.1.161,1611577651,1611577676,1611577677,1611577678,1611577678,1611577678,1611577683,25,2,5
mBackground,ID0000151,10668.000.000,192.168.1.161,1611592533,1611592631,1611592646,1611592647,1611592647,1611592647,1611592652,98,16,5
mDiffFit,ID0000258,10531.000.000,192.168.1.161,1611590913,1611591046,1611591048,1611591049,1611591049,1611591049,1611591054,133,3,5
mDiffFit,ID0000232,10278.000.000,192.168.1.161,1611582642,1611582776,1611582782,1611582786,1611582786,1611582787,1611582792,134,10,6
mBackground,ID0000305,10549.000.000,192.168.1.161,1611591110,1611591254,1611591263,1611591268,1611591268,1611591268,1611591273,144,14,5
mDiffFit,ID0000250,10220.000.000,192.168.1.161,1611578337,1611579370,1611579372,1611579374,1611579374,1611579374,1611579379,1033,4,5
mBackground,ID0000148,10660.000.000,192.168.1.161,1611592516,1611592575,1611592601,1611592604,1611592604,1611592607,1611592614,59,29,10
mDiffFit,ID0000285,10222.000.000,192.168.1.161,1611579359,1611579389,1611579390,1611579394,1611579394,1611579395,1611579400,30,5,6
mDiffFit,ID0000224,10467.000.000,192.168.1.161,1611589749,1611590044,1611590045,1611590051,1611590051,1611590051,1611590056,295,7,5
mDiffFit,ID0000203,10496.000.000,192.168.1.161,1611590050,1611590224,1611590236,1611590240,1611590240,1611590240,1611590245,174,16,5
mDiffFit,ID0000357,10325.000.000,192.168.1.161,1611584439,1611584494,1611584495,1611584495,1611584495,1611584496,1611584500,55,1,5
clean_up_local_level,0_6,10652.000.000,192.168.1.4,1611592509,1611592509,1611592524,1611592527,1611592527,1611592527,1611592534,0,18,7
mDiffFit,ID0000279,10385.000.000,192.168.1.161,1611586929,1611587029,1611587044,1611587049,1611587049,1611587050,1611587055,100,20,6
mDiffFit,ID0000249,10519.000.000,192.168.1.161,1611590896,1611590939,1611590948,1611590950,1611590950,1611590950,1611590955,43,11,5
mDiffFit,ID0000340,10449.000.000,192.168.1.161,1611588716,1611588864,1611588866,1611588867,1611588867,1611588867,1611588872,148,3,5
mDiffFit,ID0000217,10355.000.000,192.168.1.161,1611585658,1611585786,1611585788,1611585790,1611585790,1611585791,1611585795,128,4,5
register_local,0_7,10702.000.000,192.168.1.4,1611592878,1611592883,1611592885,1611592888,1611592888,1611592889,1611592894,5,5,6
clean_up_local_level,3_3,10483.000.000,192.168.1.4,1611590022,1611590023,1611590034,1611590044,1611590044,1611590044,1611590051,1,21,7
mDiffFit,ID0000406,10307.000.000,192.168.1.161,1611584075,1611584133,1611584142,1611584147,1611584147,1611584147,1611584152,58,14,5
mDiffFit,ID0000437,10444.000.000,192.168.1.161,1611588707,1611588836,1611588838,1611588839,1611588839,1611588840,1611588845,129,3,6
mDiffFit,ID0000112,10290.000.000,192.168.1.161,1611582765,1611582890,1611582900,1611582902,1611582902,1611582902,1611582907,125,12,5
mDiffFit,ID0000102,10364.000.000,192.168.1.161,1611586258,1611586345,1611586346,1611586348,1611586348,1611586348,1611586353,87,3,5
mDiffFit,ID0000136,10412.000.000,192.168.1.161,1611588124,1611588196,1611588201,1611588203,1611588203,1611588204,1611588208,72,7,5
mDiffFit,ID0000430,10448.000.000,192.168.1.161,1611588710,1611588857,1611588872,1611588878,1611588878,1611588878,1611588883,147,21,5
clean_up_local_level,0_3,10622.000.000,192.168.1.4,1611592351,1611592352,1611592365,1611592376,1611592376,1611592377,1611592385,1,24,9
register_local,0_4,10687.000.000,192.168.1.4,1611592697,1611592697,1611592699,1611592702,1611592702,1611592702,1611592708,0,5,6
clean_up_local_level,5_7,10675.000.000,192.168.1.4,1611592613,1611592617,1611592628,1611592635,1611592635,1611592637,1611592646,4,18,11
register_local,6_1,10643.000.000,192.168.1.4,1611592444,1611592447,1611592450,1611592451,1611592451,1611592451,1611592457,3,4,6
mDiffFit,ID0000358,10212.000.000,192.168.1.161,1611578119,1611578136,1611578137,1611578139,1611578139,1611578139,1611578144,17,3,5
mDiffFit,ID0000077,10600.000.000,192.168.1.161,1611592077,1611592208,1611592210,1611592214,1611592214,1611592215,1611592220,131,6,6
mBackground,ID0000458,10591.000.000,192.168.1.161,1611592055,1611592160,1611592178,1611592183,1611592183,1611592184,1611592189,105,23,6
mDiffFit,ID0000061,10482.000.000,192.168.1.161,1611589973,1611590142,1611590152,1611590154,1611590154,1611590155,1611590159,169,12,5
mDiffFit,ID0000351,10306.000.000,192.168.1.161,1611584075,1611584126,1611584127,1611584132,1611584132,1611584132,1611584137,51,6,5
mDiffFit,ID0000198,10229.000.000,192.168.1.161,1611579447,1611579466,1611579470,1611579473,1611579473,1611579473,1611579478,19,7,5
register_local,13_1,10501.000.000,192.168.1.4,1611590223,1611590225,1611590229,1611590235,1611590235,1611590235,1611590240,2,10,5
mDiffFit,ID0000064,10366.000.000,192.168.1.161,1611586259,1611586364,1611586365,1611586368,1611586368,1611586368,1611586373,105,4,5
mBackground,ID0000464,10577.000.000,192.168.1.161,1611592032,1611592035,1611592046,1611592050,1611592050,1611592050,1611592056,3,15,6
mDiffFit,ID0000208,10497.000.000,192.168.1.161,1611590050,1611590232,1611590234,1611590235,1611590235,1611590235,1611590240,182,3,5
mDiffFit,ID0000256,10264.000.000,192.168.1.161,1611582248,1611582347,1611582349,1611582350,1611582350,1611582351,1611582357,99,3,7
mDiffFit,ID0000073,10315.000.000,192.168.1.161,1611584370,1611584433,1611584435,1611584440,1611584440,1611584441,1611584445,63,7,5
clean_up_local_level,5_3,10516.000.000,192.168.1.4,1611590895,1611590895,1611590906,1611590908,1611590908,1611590908,1611590914,0,13,6
mDiffFit,ID0000031,10397.000.000,192.168.1.161,1611587000,1611587097,1611587099,1611587100,1611587100,1611587100,1611587105,97,3,5
clean_up_local_level,2_7,10608.000.000,192.168.1.4,1611592150,1611592154,1611592166,1611592171,1611592171,1611592172,1611592177,4,17,6
mDiffFit,ID0000050,10637.000.000,192.168.1.161,1611592373,1611592447,1611592454,1611592457,1611592457,1611592457,1611592462,74,10,5
mDiffFit,ID0000273,10380.000.000,192.168.1.161,1611586922,1611586992,1611587009,1611587015,1611587015,1611587016,1611587021,70,23,6
mDiffFit,ID0000209,10484.000.000,192.168.1.161,1611590023,1611590148,1611590149,1611590154,1611590154,1611590154,1611590159,125,6,5
register_local,20_1,10500.000.000,192.168.1.4,1611590148,1611590149,1611590150,1611590154,1611590154,1611590155,1611590159,1,5,5
mBackground,ID0000455,10586.000.000,192.168.1.161,1611592039,1611592118,1611592135,1611592137,1611592137,1611592139,1611592143,79,19,6
mDiffFit,ID0000035,10234.000.000,192.168.1.161,1611579876,1611579882,1611579892,1611579892,1611579892,1611579892,1611579897,6,10,5
mDiffFit,ID0000088,10209.000.000,192.168.1.161,1611577651,1611577682,1611577684,1611577688,1611577688,1611577688,1611577693,31,6,5
mDiffFit,ID0000348,10216.000.000,192.168.1.161,1611578184,1611578203,1611578210,1611578211,1611578211,1611578211,1611578216,19,8,5
mProject,ID0000327,10170.000.000,192.168.1.161,1611573329,1611579487,1611580971,1611580975,1611580975,1611580975,1611580980,6158,1488,5
mDiffFit,ID0000284,10465.000.000,192.168.1.161,1611589749,1611590032,1611590034,1611590044,1611590044,1611590044,1611590051,283,12,7
stage_in_local_local,2_0,10145.000.000,192.168.1.4,1611573091,1611573096,1611573458,1611573459,1611573459,1611573459,1611573464,5,363,5
mDiffFit,ID0000192,10353.000.000,192.168.1.161,1611585655,1611585774,1611585787,1611585790,1611585790,1611585790,1611585795,119,16,5
mDiffFit,ID0000036,10472.000.000,192.168.1.161,1611589960,1611590076,1611590085,1611590087,1611590087,1611590089,1611590093,116,11,6
mDiffFit,ID0000080,10404.000.000,192.168.1.161,1611588117,1611588123,1611588124,1611588131,1611588131,1611588131,1611588136,6,8,5
clean_up_local_level,8_7,10553.000.000,192.168.1.4,1611591315,1611591320,1611591331,1611591335,1611591335,1611591336,1611591341,5,15,6
mProject,ID0000167,10175.000.000,192.168.1.161,1611573336,1611581551,1611582626,1611582631,1611582631,1611582631,1611582636,8215,1080,5
mBackground,ID0000142,10657.000.000,192.168.1.161,1611592515,1611592543,1611592567,1611592571,1611592571,1611592573,1611592578,28,28,7
mDiffFit,ID0000390,10440.000.000,192.168.1.161,1611588691,1611588806,1611588808,1611588809,1611588809,1611588809,1611588814,115,3,5
mDiffFit,ID0000257,10331.000.000,192.168.1.161,1611585242,1611585628,1611585629,1611585629,1611585629,1611585629,1611585634,386,1,5
mProject,ID0000160,10193.000.000,192.168.1.161,1611573470,1611588887,1611590011,1611590012,1611590012,1611590012,1611590017,15417,1125,5
mProject,ID0000003,10198.000.000,192.168.1.161,1611573476,1611590575,1611592337,1611592341,1611592341,1611592341,1611592346,17099,1766,5
mDiffFit,ID0000411,10243.000.000,192.168.1.161,1611580986,1611581070,1611581071,1611581075,1611581075,1611581076,1611581081,84,5,6
mDiffFit,ID0000114,10405.000.000,192.168.1.161,1611588117,1611588130,1611588131,1611588136,1611588136,1611588137,1611588142,13,6,6
mBackground,ID0000145,10653.000.000,192.168.1.161,1611592509,1611592513,1611592523,1611592527,1611592527,1611592527,1611592534,4,14,7
mDiffFit,ID0000065,10228.000.000,192.168.1.161,1611579427,1611579464,1611579468,1611579473,1611579473,1611579473,1611579478,37,9,5
mDiffFit,ID0000392,10240.000.000,192.168.1.161,1611580985,1611581049,1611581051,1611581053,1611581053,1611581054,1611581059,64,4,6
register_local,8_1,10618.000.000,192.168.1.4,1611592330,1611592331,1611592334,1611592336,1611592336,1611592337,1611592341,1,5,5
clean_up_local_level,0_11,10701.000.000,192.168.1.4,1611592878,1611592878,1611592887,1611592888,1611592888,1611592889,1611592894,0,10,6
mDiffFit,ID0000094,10479.000.000,192.168.1.161,1611589973,1611590119,1611590130,1611590135,1611590135,1611590136,1611590141,146,16,6
mViewer,ID0000471,10620.000.000,192.168.1.161,1611592346,1611592349,1611592378,1611592385,1611592385,1611592386,1611592391,3,36,6
mDiffFit,ID0000429,10502.000.000,192.168.1.161,1611590460,1611590467,1611590468,1611590475,1611590475,1611590475,1611590480,7,8,5
mDiffFit,ID0000447,10504.000.000,192.168.1.161,1611590460,1611590481,1611590483,1611590485,1611590485,1611590485,1611590490,21,4,5
mDiffFit,ID0000229,10271.000.000,192.168.1.161,1611582356,1611582405,1611582407,1611582410,1611582410,1611582410,1611582415,49,5,5
mProject,ID0000325,10189.000.000,192.168.1.161,1611573469,1611587112,1611588650,1611588657,1611588657,1611588657,1611588667,13643,1545,10
mDiffFit,ID0000221,10283.000.000,192.168.1.161,1611582648,1611582829,1611582830,1611582834,1611582834,1611582835,1611582840,181,5,6
mDiffFit,ID0000347,10345.000.000,192.168.1.161,1611585601,1611585719,1611585722,1611585726,1611585726,1611585727,1611585732,118,7,6
stage_in_remote_local,0_4,10139.000.000,192.168.1.4,1611573079,1611573082,1611573084,1611573085,1611573085,1611573085,1611573091,3,3,6
mDiffFit,ID0000366,10260.000.000,192.168.1.161,1611581445,1611581511,1611581512,1611581515,1611581515,1611581515,1611581520,66,4,5
stage_in_local_local,0_0,10135.000.000,192.168.1.4,1611573073,1611573078,1611573404,1611573407,1611573407,1611573407,1611573412,5,329,5
mDiffFit,ID0000448,10321.000.000,192.168.1.161,1611584428,1611584469,1611584477,1611584479,1611584479,1611584479,1611584484,41,10,5
mDiffFit,ID0000204,10488.000.000,192.168.1.161,1611590029,1611590177,1611590179,1611590181,1611590181,1611590182,1611590186,148,4,5
mDiffFit,ID0000111,10598.000.000,192.168.1.161,1611592076,1611592205,1611592209,1611592214,1611592214,1611592215,1611592220,129,9,6
mDiffFit,ID0000384,10509.000.000,192.168.1.161,1611590467,1611590523,1611590524,1611590528,1611590528,1611590528,1611590533,56,5,5
register_local,17_1,10644.000.000,192.168.1.4,1611592457,1611592457,1611592459,1611592462,1611592462,1611592462,1611592468,0,5,6
mDiffFit,ID0000033,10238.000.000,192.168.1.161,1611579877,1611579919,1611579920,1611579924,1611579924,1611579925,1611579929,42,5,5
register_local,0_5,10689.000.000,192.168.1.4,1611592707,1611592713,1611592719,1611592724,1611592724,1611592724,1611592729,6,11,5
mDiffFit,ID0000194,10528.000.000,192.168.1.161,1611590908,1611591021,1611591022,1611591024,1611591024,1611591024,1611591029,113,3,5
mDiffFit,ID0000418,10305.000.000,192.168.1.161,1611584075,1611584114,1611584120,1611584121,1611584121,1611584121,1611584126,39,7,5
mBackground,ID0000456,10585.000.000,192.168.1.161,1611592039,1611592118,1611592132,1611592137,1611592137,1611592138,1611592143,79,19,6
mDiffFit,ID0000066,10607.000.000,192.168.1.161,1611592096,1611592273,1611592276,1611592277,1611592277,1611592278,1611592282,177,4,5
clean_up_local_level,3_7,10679.000.000,192.168.1.4,1611592643,1611592645,1611592657,1611592661,1611592661,1611592661,1611592666,2,16,5
mDiffFit,ID0000292,10334.000.000,192.168.1.161,1611585248,1611585656,1611585658,1611585658,1611585658,1611585659,1611585664,408,2,6
mDiffFit,ID0000345,10507.000.000,192.168.1.161,1611590466,1611590503,1611590504,1611590506,1611590506,1611590506,1611590511,37,3,5
mDiffFit,ID0000132,10414.000.000,192.168.1.161,1611588131,1611588214,1611588215,1611588219,1611588219,1611588219,1611588224,83,5,5
stage_in_remote_local,2_4,10146.000.000,192.168.1.4,1611573091,1611573096,1611573099,1611573103,1611573103,1611573103,1611573108,5,7,5
stage_in_remote_local,1_4,10144.000.000,192.168.1.4,1611573091,1611573096,1611573099,1611573103,1611573103,1611573103,1611573108,5,7,5
mDiffFit,ID0000389,10245.000.000,192.168.1.161,1611581037,1611581089,1611581095,1611581096,1611581096,1611581096,1611581101,52,7,5
mDiffFit,ID0000233,10378.000.000,192.168.1.161,1611586922,1611586983,1611586988,1611586994,1611586994,1611586995,1611587002,61,11,8
mImgtbl,ID0000312,10554.000.000,192.168.1.161,1611591315,1611591335,1611591337,1611591341,1611591341,1611591341,1611591346,20,6,5
mDiffFit,ID0000248,10348.000.000,192.168.1.161,1611585647,1611585736,1611585738,1611585738,1611585738,1611585738,1611585743,89,2,5
mProject,ID0000007,10191.000.000,192.168.1.161,1611573470,1611588222,1611589947,1611589949,1611589949,1611589949,1611589954,14752,1727,5
mDiffFit,ID0000098,10476.000.000,192.168.1.161,1611589966,1611590103,1611590106,1611590109,1611590109,1611590109,1611590114,137,6,5
DAGMAN,,10130.0,,1611573053,,,,,,1611592909,,,
stage_in_remote_local,1_1,10141.000.000,192.168.1.4,1611573079,1611573081,1611573084,1611573085,1611573085,1611573085,1611573091,2,4,6
mDiffFit,ID0000117,10596.000.000,192.168.1.161,1611592071,1611592193,1611592195,1611592196,1611592196,1611592197,1611592201,122,3,5
mDiffFit,ID0000180,10517.000.000,192.168.1.161,1611590895,1611590921,1611590922,1611590924,1611590924,1611590924,1611590929,26,3,5
register_local,9_1,10453.000.000,192.168.1.4,1611588852,1611588857,1611588859,1611588861,1611588861,1611588862,1611588867,5,4,6
mBackground,ID0000303,10542.000.000,192.168.1.161,1611591102,1611591163,1611591173,1611591178,1611591178,1611591178,1611591183,61,15,5
mDiffFit,ID0000444,10513.000.000,192.168.1.161,1611590473,1611590555,1611590561,1611590564,1611590564,1611590564,1611590569,82,9,5
mBackground,ID0000302,10543.000.000,192.168.1.161,1611591102,1611591177,1611591186,1611591189,1611591189,1611591189,1611591194,75,12,5
register_local,14_1,10402.000.000,192.168.1.4,1611587048,1611587051,1611587055,1611587060,1611587060,1611587061,1611587066,3,9,6
mDiffFit,ID0000419,10300.000.000,192.168.1.161,1611584068,1611584074,1611584075,1611584080,1611584080,1611584080,1611584085,6,6,5
mDiffFit,ID0000190,10232.000.000,192.168.1.161,1611579451,1611579479,1611579482,1611579484,1611579484,1611579486,1611579490,28,5,6
mViewer,ID0000314,10556.000.000,192.168.1.161,1611591431,1611591433,1611591457,1611591461,1611591461,1611591461,1611591466,2,28,5
mDiffFit,ID0000100,10473.000.000,192.168.1.161,1611589960,1611590083,1611590084,1611590087,1611590087,1611590089,1611590093,123,4,6
mBackground,ID0000465,10588.000.000,192.168.1.161,1611592047,1611592139,1611592154,1611592159,1611592159,1611592160,1611592165,92,20,6
mDiffFit,ID0000291,10267.000.000,192.168.1.161,1611582249,1611582374,1611582379,1611582384,1611582384,1611582384,1611582389,125,10,5
clean_up_local_level,0_9,10694.000.000,192.168.1.4,1611592774,1611592774,1611592792,1611592795,1611592795,1611592796,1611592801,0,21,6
mDiffFit,ID0000342,10436.000.000,192.168.1.161,1611588687,1611588788,1611588790,1611588793,1611588793,1611588794,1611588799,101,5,6
mDiffFit,ID0000236,10274.000.000,192.168.1.161,1611582357,1611582432,1611582433,1611582436,1611582436,1611582437,1611582441,75,4,5
mDiffFit,ID0000290,10457.000.000,192.168.1.161,1611589737,1611589972,1611589974,1611589979,1611589979,1611589980,1611589985,235,7,6
mDiffFit,ID0000212,10490.000.000,192.168.1.161,1611590033,1611590187,1611590190,1611590192,1611590192,1611590194,1611590198,154,5,6
register_local,1_0,10427.000.000,192.168.1.4,1611588672,1611588679,1611588682,1611588691,1611588691,1611588691,1611588702,7,12,11
mProject,ID0000318,10180.000.000,192.168.1.161,1611573417,1611584015,1611585581,1611585584,1611585584,1611585584,1611585589,10598,1569,5
mProject,ID0000014,10176.000.000,192.168.1.161,1611573336,1611582236,1611583931,1611583934,1611583934,1611583934,1611583939,8900,1698,5
mDiffFit,ID0000201,10266.000.000,192.168.1.161,1611582248,1611582366,1611582368,1611582373,1611582373,1611582373,1611582378,118,7,5
mDiffFit,ID0000041,10604.000.000,192.168.1.161,1611592094,1611592259,1611592262,1611592265,1611592265,1611592265,1611592270,165,6,5
mBackground,ID0000298,10539.000.000,192.168.1.161,1611591096,1611591125,1611591134,1611591137,1611591137,1611591137,1611591142,29,12,5
mDiffFit,ID0000356,10242.000.000,192.168.1.161,1611580986,1611581063,1611581065,1611581070,1611581070,1611581070,1611581075,77,7,5
register_local,27_1,10641.000.000,192.168.1.4,1611592403,1611592406,1611592414,1611592418,1611592418,1611592419,1611592425,3,12,7
clean_up_local_level,1_7,10684.000.000,192.168.1.4,1611592671,1611592677,1611592692,1611592697,1611592697,1611592697,1611592702,6,20,5
mDiffFit,ID0000379,10446.000.000,192.168.1.161,1611588708,1611588847,1611588849,1611588853,1611588853,1611588856,1611588861,139,6,8
mDiffFit,ID0000058,10628.000.000,192.168.1.161,1611592357,1611592393,1611592397,1611592404,1611592404,1611592406,1611592411,36,11,7
mDiffFit,ID0000403,10560.000.000,192.168.1.161,1611591863,1611591892,1611591894,1611591897,1611591897,1611591898,1611591903,29,5,6
mBackground,ID0000460,10592.000.000,192.168.1.161,1611592056,1611592167,1611592181,1611592183,1611592183,1611592185,1611592189,111,16,6
mDiffFit,ID0000039,10362.000.000,192.168.1.161,1611586258,1611586331,1611586332,1611586337,1611586337,1611586337,1611586342,73,6,5
mBackground,ID0000454,10589.000.000,192.168.1.161,1611592055,1611592144,1611592162,1611592165,1611592165,1611592167,1611592171,89,21,6
mDiffFit,ID0000426,10417.000.000,192.168.1.161,1611588656,1611588666,1611588680,1611588681,1611588681,1611588682,1611588691,10,15,10
stage_in_remote_local,0_0,10134.000.000,192.168.1.4,1611573073,1611573078,1611573080,1611573085,1611573085,1611573085,1611573091,5,7,6
register_local,10_1,10401.000.000,192.168.1.4,1611587009,1611587012,1611587019,1611587021,1611587021,1611587021,1611587026,3,9,5
mBackground,ID0000453,10578.000.000,192.168.1.161,1611592033,1611592052,1611592066,1611592071,1611592071,1611592071,1611592077,19,19,6
mDiffFit,ID0000115,10288.000.000,192.168.1.161,1611582759,1611582876,1611582878,1611582880,1611582880,1611582881,1611582886,117,4,6
mProject,ID0000164,10163.000.000,192.168.1.161,1611573317,1611577224,1611578324,1611578327,1611578327,1611578327,1611578332,3907,1103,5
mDiffFit,ID0000400,10563.000.000,192.168.1.161,1611591869,1611591902,1611591910,1611591914,1611591914,1611591915,1611591920,33,12,6
mDiffFit,ID0000075,10359.000.000,192.168.1.161,1611586252,1611586287,1611586294,1611586296,1611586296,1611586296,1611586301,35,9,5
mAdd,ID0000470,10613.000.000,192.168.1.161,1611592264,1611592307,1611592331,1611592336,1611592336,1611592336,1611592341,43,29,5
mBackground,ID0000152,10666.000.000,192.168.1.161,1611592526,1611592614,1611592640,1611592647,1611592647,1611592647,1611592652,88,33,5
mDiffFit,ID0000018,10624.000.000,192.168.1.161,1611592351,1611592378,1611592382,1611592385,1611592385,1611592386,1611592391,27,7,6
mProject,ID0000158,10186.000.000,192.168.1.161,1611573423,1611585800,1611586891,1611586893,1611586893,1611586894,1611586899,12377,1093,6
mDiffFit,ID0000175,10494.000.000,192.168.1.161,1611590041,1611590212,1611590215,1611590215,1611590215,1611590216,1611590224,171,3,9
mDiffFit,ID0000254,10461.000.000,192.168.1.161,1611589743,1611590001,1611590002,1611590007,1611590007,1611590007,1611590012,258,6,5
mDiffFit,ID0000089,10293.000.000,192.168.1.161,1611583944,1611583962,1611583963,1611583966,1611583966,1611583967,1611583972,18,4,6
mDiffFit,ID0000176,10376.000.000,192.168.1.161,1611586916,1611586972,1611586974,1611586983,1611586983,1611586983,1611586994,56,11,11
stage_in_remote_local,1_0,10142.000.000,192.168.1.4,1611573085,1611573085,1611573088,1611573091,1611573091,1611573091,1611573097,0,6,6
mProject,ID0000012,10196.000.000,192.168.1.161,1611573476,1611590234,1611592050,1611592056,1611592056,1611592056,1611592061,16758,1822,5
mDiffFit,ID0000032,10632.000.000,192.168.1.161,1611592363,1611592413,1611592434,1611592437,1611592437,1611592439,1611592445,50,24,8
mDiffFit,ID0000090,10409.000.000,192.168.1.161,1611588123,1611588167,1611588169,1611588173,1611588173,1611588173,1611588178,44,6,5
mDiffFit,ID0000054,10633.000.000,192.168.1.161,1611592364,1611592413,1611592415,1611592418,1611592418,1611592420,1611592425,49,5,7
mProject,ID0000315,10190.000.000,192.168.1.161,1611573470,1611587112,1611588646,1611588649,1611588649,1611588650,1611588657,13642,1537,8
mDiffFit,ID0000436,10450.000.000,192.168.1.161,1611588716,1611588873,1611588885,1611588888,1611588888,1611588889,1611588894,157,15,6
mDiffFit,ID0000287,10332.000.000,192.168.1.161,1611585248,1611585636,1611585642,1611585648,1611585648,1611585648,1611585658,388,12,10
mBackground,ID0000154,10655.000.000,192.168.1.161,1611592510,1611592543,1611592565,1611592571,1611592571,1611592573,1611592578,33,28,7
stage_in_remote_local,0_5,10138.000.000,192.168.1.4,1611573079,1611573082,1611573087,1611573091,1611573091,1611573092,1611573097,3,9,6
mProject,ID0000166,10156.000.000,192.168.1.161,1611573309,1611574871,1611575947,1611575950,1611575950,1611575950,1611575955,1562,1079,5
register_local,31_1,10672.000.000,192.168.1.4,1611592570,1611592573,1611592578,1611592584,1611592584,1611592587,1611592592,3,11,8
mProject,ID0000004,10159.000.000,192.168.1.161,1611573310,1611575492,1611577213,1611577215,1611577215,1611577215,1611577220,2182,1723,5
mDiffFit,ID0000405,10558.000.000,192.168.1.161,1611591863,1611591881,1611591883,1611591891,1611591891,1611591892,1611591897,18,10,6
mDiffFit,ID0000255,10218.000.000,192.168.1.161,1611578337,1611579351,1611579352,1611579353,1611579353,1611579353,1611579359,1014,2,6
mProject,ID0000330,10194.000.000,192.168.1.161,1611573476,1611588898,1611590447,1611590450,1611590450,1611590451,1611590455,15422,1552,5
mDiffFit,ID0000338,10429.000.000,192.168.1.161,1611588673,1611588744,1611588748,1611588749,1611588749,1611588750,1611588755,71,5,6
stage_in_remote_local,0_1,10133.000.000,192.168.1.4,1611573073,1611573078,1611573080,1611573085,1611573085,1611573085,1611573091,5,7,6
register_local,1_4,10686.000.000,192.168.1.4,1611592678,1611592683,1611592689,1611592691,1611592691,1611592692,1611592697,5,8,6
mBackground,ID0000311,10545.000.000,192.168.1.161,1611591102,1611591202,1611591212,1611591215,1611591215,1611591215,1611591220,100,13,5
mDiffFit,ID0000350,10205.000.000,192.168.1.161,1611576603,1611576620,1611576627,1611576629,1611576629,1611576629,1611576634,17,9,5
mDiffFit,ID0000231,10276.000.000,192.168.1.161,1611582362,1611582501,1611582511,1611582516,1611582516,1611582516,1611582521,139,15,5
mProject,ID0000171,10154.000.000,192.168.1.161,1611573304,1611573316,1611574404,1611574407,1611574407,1611574407,1611574412,12,1091,5
mDiffFit,ID0000130,10602.000.000,192.168.1.161,1611592077,1611592236,1611592246,1611592246,1611592246,1611592246,1611592251,159,10,5
mDiffFit,ID0000380,10344.000.000,192.168.1.161,1611585601,1611585711,1611585712,1611585716,1611585716,1611585717,1611585721,110,5,5
mDiffFit,ID0000286,10265.000.000,192.168.1.161,1611582248,1611582354,1611582360,1611582362,1611582362,1611582363,1611582368,106,8,6
register_local,30_1,10674.000.000,192.168.1.4,1611592592,1611592595,1611592604,1611592614,1611592614,1611592616,1611592626,3,19,12
mDiffFit,ID0000086,10225.000.000,192.168.1.161,1611579425,1611579446,1611579458,1611579461,1611579461,1611579462,1611579467,21,15,6
mDiffFit,ID0000120,10407.000.000,192.168.1.161,1611588118,1611588148,1611588154,1611588158,1611588158,1611588158,1611588163,30,10,5
stage_out_local_local,0_7,10700.000.000,192.168.1.4,1611592857,1611592862,1611592866,1611592867,1611592867,1611592867,1611592872,5,5,5
mDiffFit,ID0000068,10299.000.000,192.168.1.161,1611583951,1611584013,1611584015,1611584018,1611584018,1611584018,1611584023,62,5,5
register_local,2_1,10614.000.000,192.168.1.4,1611592265,1611592273,1611592281,1611592282,1611592282,1611592283,1611592290,8,9,8
mDiffFit,ID0000026,10395.000.000,192.168.1.161,1611586992,1611587080,1611587083,1611587084,1611587084,1611587084,1611587089,88,4,5
mDiffFit,ID0000399,10564.000.000,192.168.1.161,1611591869,1611591919,1611591932,1611591935,1611591935,1611591935,1611591940,50,16,5
register_local,21_1,10532.000.000,192.168.1.4,1611590934,1611590934,1611590938,1611590939,1611590939,1611590939,1611590945,0,5,6
mDiffFit,ID0000268,10224.000.000,192.168.1.161,1611579359,1611579437,1611579438,1611579442,1611579442,1611579442,1611579451,78,5,9
mDiffFit,ID0000133,10254.000.000,192.168.1.161,1611581247,1611581476,1611581478,1611581483,1611581483,1611581483,1611581488,229,7,5
mProject,ID0000016,10168.000.000,192.168.1.161,1611573324,1611579481,1611581234,1611581236,1611581236,1611581236,1611581241,6157,1755,5
mDiffFit,ID0000272,10336.000.000,192.168.1.161,1611585248,1611585664,1611585667,1611585669,1611585669,1611585670,1611585675,416,5,6
mDiffFit,ID0000377,10419.000.000,192.168.1.161,1611588656,1611588690,1611588691,1611588702,1611588702,1611588702,1611588710,34,12,8
mConcatFit,ID0000294,10535.000.000,192.168.1.161,1611591059,1611591060,1611591064,1611591065,1611591065,1611591065,1611591070,1,5,5
mDiffFit,ID0000385,10567.000.000,192.168.1.161,1611591875,1611591938,1611591953,1611591957,1611591957,1611591958,1611591963,63,19,6
mDiffFit,ID0000354,10451.000.000,192.168.1.161,1611588716,1611588878,1611588881,1611588883,1611588883,1611588883,1611588888,162,5,5
mDiffFit,ID0000074,10309.000.000,192.168.1.161,1611584363,1611584376,1611584386,1611584390,1611584390,1611584391,1611584396,13,14,6
mDiffFit,ID0000331,10438.000.000,192.168.1.161,1611588688,1611588798,1611588814,1611588814,1611588814,1611588814,1611588819,110,16,5
mDiffFit,ID0000179,10372.000.000,192.168.1.161,1611586911,1611586946,1611586949,1611586951,1611586951,1611586952,1611586957,35,5,6
mDiffFit,ID0000027,10597.000.000,192.168.1.161,1611592071,1611592193,1611592195,1611592196,1611592196,1611592196,1611592201,122,3,5
register_local,0_6,10698.000.000,192.168.1.4,1611592812,1611592812,1611592814,1611592817,1611592817,1611592817,1611592822,0,5,5
mDiffFit,ID0000025,10391.000.000,192.168.1.161,1611586979,1611587068,1611587070,1611587073,1611587073,1611587073,1611587078,89,5,5
mDiffFit,ID0000371,10258.000.000,192.168.1.161,1611581444,1611581498,1611581499,1611581499,1611581499,1611581499,1611581504,54,1,5
mDiffFit,ID0000343,10435.000.000,192.168.1.161,1611588681,1611588779,1611588780,1611588782,1611588782,1611588783,1611588787,98,3,5
clean_up_local_level,8_3,10455.000.000,192.168.1.4,1611589736,1611589736,1611589747,1611589749,1611589749,1611589750,1611589754,0,13,5
mDiffFit,ID0000220,10201.000.000,192.168.1.161,1611575961,1611576558,1611576559,1611576562,1611576562,1611576562,1611576567,597,4,5
mDiffFit,ID0000421,10302.000.000,192.168.1.161,1611584069,1611584093,1611584094,1611584095,1611584095,1611584095,1611584100,24,2,5
mDiffFit,ID0000450,10510.000.000,192.168.1.161,1611590467,1611590529,1611590535,1611590538,1611590538,1611590539,1611590544,62,9,6
mDiffFit,ID0000369,10257.000.000,192.168.1.161,1611581443,1611581491,1611581492,1611581494,1611581494,1611581494,1611581499,48,3,5
mProject,ID0000326,10151.000.000,192.168.1.161,1611573303,1611573316,1611574875,1611574878,1611574878,1611574878,1611574883,13,1562,5
mDiffFit,ID0000030,10408.000.000,192.168.1.161,1611588123,1611588160,1611588161,1611588163,1611588163,1611588164,1611588168,37,3,5
mDiffFit,ID0000333,10432.000.000,192.168.1.161,1611588680,1611588759,1611588762,1611588766,1611588766,1611588766,1611588771,79,7,5
clean_up_local_level,0_4,10646.000.000,192.168.1.4,1611592473,1611592473,1611592481,1611592483,1611592483,1611592483,1611592489,0,10,6
mDiffFit,ID0000259,10520.000.000,192.168.1.161,1611590896,1611590954,1611590955,1611590960,1611590960,1611590960,1611590965,58,6,5
register_local,2_4,10691.000.000,192.168.1.4,1611592729,1611592730,1611592734,1611592734,1611592734,1611592736,1611592742,1,4,8
mDiffFit,ID0000402,10561.000.000,192.168.1.161,1611591864,1611591892,1611591894,1611591897,1611591897,1611591899,1611591903,28,5,6
mDiffFit,ID0000271,10269.000.000,192.168.1.161,1611582254,1611582392,1611582393,1611582394,1611582394,1611582394,1611582399,138,2,5
mDiffFit,ID0000252,10384.000.000,192.168.1.161,1611586929,1611587020,1611587034,1611587037,1611587037,1611587037,1611587042,91,17,5
mDiffFit,ID0000225,10200.000.000,192.168.1.161,1611575499,1611575953,1611575954,1611575955,1611575955,1611575955,1611575961,454,2,6
clean_up_local_level,7_7,10678.000.000,192.168.1.4,1611592633,1611592638,1611592651,1611592652,1611592652,1611592655,1611592661,5,14,9
mDiffFit,ID0000242,10350.000.000,192.168.1.161,1611585648,1611585748,1611585763,1611585763,1611585763,1611585764,1611585768,100,15,5
mConcatFit,ID0000451,10575.000.000,192.168.1.161,1611591996,1611591997,1611592000,1611592002,1611592002,1611592002,1611592007,1,5,5
mDiffFit,ID0000020,10393.000.000,192.168.1.161,1611586989,1611587068,1611587087,1611587089,1611587089,1611587089,1611587094,79,21,5
mDiffFit,ID0000046,10640.000.000,192.168.1.161,1611592384,1611592447,1611592457,1611592462,1611592462,1611592462,1611592468,63,15,6
mDiffFit,ID0000283,10381.000.000,192.168.1.161,1611586922,1611586998,1611587008,1611587009,1611587009,1611587010,1611587015,76,11,6
mDiffFit,ID0000076,10311.000.000,192.168.1.161,1611584364,1611584409,1611584411,1611584414,1611584414,1611584414,1611584420,45,5,6
mDiffFit,ID0000376,10337.000.000,192.168.1.161,1611585594,1611585668,1611585678,1611585680,1611585680,1611585682,1611585687,74,12,7
mDiffFit,ID0000391,10215.000.000,192.168.1.161,1611578184,1611578196,1611578197,1611578200,1611578200,1611578201,1611578206,12,4,6
mBgModel,ID0000452,10576.000.000,192.168.1.161,1611592012,1611592012,1611592020,1611592022,1611592022,1611592022,1611592027,0,10,5
mProject,ID0000013,10157.000.000,192.168.1.161,1611573309,1611574898,1611576540,1611576542,1611576542,1611576542,1611576547,1589,1644,5
mDiffFit,ID0000238,10328.000.000,192.168.1.161,1611585242,1611585601,1611585602,1611585607,1611585607,1611585607,1611585613,359,6,6
register_local,23_1,10615.000.000,192.168.1.4,1611592289,1611592291,1611592296,1611592301,1611592301,1611592301,1611592308,2,10,7
mProject,ID0000005,10178.000.000,192.168.1.161,1611573336,1611582627,1611584352,1611584352,1611584352,1611584352,1611584357,9291,1725,5
mDiffFit,ID0000234,10272.000.000,192.168.1.161,1611582356,1611582412,1611582414,1611582415,1611582415,1611582416,1611582421,56,3,6
mBackground,ID0000457,10582.000.000,192.168.1.161,1611592039,1611592095,1611592112,1611592116,1611592116,1611592118,1611592122,56,21,6
mDiffFit,ID0000199,10462.000.000,192.168.1.161,1611589743,1611590009,1611590011,1611590012,1611590012,1611590012,1611590017,266,3,5
mDiffFit,ID0000078,10316.000.000,192.168.1.161,1611584370,1611584439,1611584443,1611584445,1611584445,1611584445,1611584450,69,6,5
mDiffFit,ID0000397,10566.000.000,192.168.1.161,1611591870,1611591933,1611591937,1611591940,1611591940,1611591941,1611591946,63,7,6
mDiffFit,ID0000105,10203.000.000,192.168.1.161,1611576552,1611576576,1611576577,1611576582,1611576582,1611576582,1611576587,24,6,5
mProject,ID0000321,10158.000.000,192.168.1.161,1611573310,1611575071,1611576587,1611576592,1611576592,1611576593,1611576598,1761,1521,6
mBackground,ID0000296,10541.000.000,192.168.1.161,1611591096,1611591150,1611591159,1611591162,1611591162,1611591163,1611591168,54,12,6
mDiffFit,ID0000096,10603.000.000,192.168.1.161,1611592085,1611592240,1611592247,1611592252,1611592252,1611592253,1611592257,155,12,5
mDiffFit,ID0000116,10361.000.000,192.168.1.161,1611586252,1611586316,1611586325,1611586326,1611586326,1611586326,1611586331,64,10,5
mProject,ID0000168,10185.000.000,192.168.1.161,1611573423,1611585789,1611586897,1611586899,1611586899,1611586899,1611586906,12366,1110,7
register_local,4_4,10682.000.000,192.168.1.4,1611592660,1611592666,1611592668,1611592672,1611592672,1611592672,1611592679,6,6,7
mBackground,ID0000459,10590.000.000,192.168.1.161,1611592055,1611592144,1611592160,1611592165,1611592165,1611592166,1611592171,89,21,6
mDiffFit,ID0000395,10511.000.000,192.168.1.161,1611590468,1611590541,1611590542,1611590544,1611590544,1611590544,1611590549,73,3,5
mDiffFit,ID0000134,10406.000.000,192.168.1.161,1611588118,1611588137,1611588143,1611588147,1611588147,1611588148,1611588153,19,10,6
mDiffFit,ID0000126,10251.000.000,192.168.1.161,1611581247,1611581451,1611581457,1611581462,1611581462,1611581462,1611581467,204,11,5
create_dir_montage,local_0,10131.000.000,192.168.1.4,1611573057,1611573058,1611573061,1611573062,1611573062,1611573062,1611573067,1,4,5
stage_in_remote_local,0_2,10132.000.000,192.168.1.4,1611573072,1611573073,1611573077,1611573079,1611573079,1611573080,1611573085,1,6,6
mDiffFit,ID0000359,10514.000.000,192.168.1.161,1611590474,1611590567,1611590568,1611590569,1611590569,1611590569,1611590574,93,2,5
mBackground,ID0000468,10583.000.000,192.168.1.161,1611592039,1611592095,1611592111,1611592116,1611592116,1611592117,1611592122,56,21,6
mDiffFit,ID0000024,10392.000.000,192.168.1.161,1611586981,1611587068,1611587071,1611587073,1611587073,1611587073,1611587078,87,5,5
mDiffFit,ID0000398,10565.000.000,192.168.1.161,1611591870,1611591919,1611591928,1611591930,1611591930,1611591930,1611591935,49,11,5
mDiffFit,ID0000394,10214.000.000,192.168.1.161,1611578184,1611578190,1611578191,1611578195,1611578195,1611578195,1611578200,6,5,5
mProject,ID0000159,10167.000.000,192.168.1.161,1611573323,1611578324,1611579434,1611579437,1611579437,1611579438,1611579442,5001,1113,5
mDiffFit,ID0000230,10523.000.000,192.168.1.161,1611590902,1611590976,1611590977,1611590981,1611590981,1611590982,1611590987,74,5,6
mViewer,ID0000157,10696.000.000,192.168.1.161,1611592775,1611592777,1611592803,1611592807,1611592807,1611592807,1611592812,2,30,5
mProject,ID0000161,10155.000.000,192.168.1.161,1611573304,1611574404,1611575488,1611575489,1611575489,1611575489,1611575494,1100,1085,5
mDiffFit,ID0000378,10343.000.000,192.168.1.161,1611585601,1611585707,1611585711,1611585716,1611585716,1611585716,1611585721,106,9,5
mProject,ID0000170,10192.000.000,192.168.1.161,1611573470,1611588657,1611589724,1611589726,1611589726,1611589726,1611589731,15187,1069,5
mDiffFit,ID0000177,10368.000.000,192.168.1.161,1611586905,1611586915,1611586927,1611586930,1611586930,1611586930,1611586939,10,15,9
mProject,ID0000169,10166.000.000,192.168.1.161,1611573323,1611578218,1611579345,1611579348,1611579348,1611579349,1611579353,4895,1130,5
mDiffFit,ID0000388,10422.000.000,192.168.1.161,1611588664,1611588702,1611588716,1611588716,1611588716,1611588717,1611588721,38,14,5
register_local,0_3,10664.000.000,192.168.1.4,1611592523,1611592525,1611592528,1611592534,1611592534,1611592534,1611592543,2,9,9
mDiffFit,ID0000206,10485.000.000,192.168.1.161,1611590024,1611590156,1611590171,1611590175,1611590175,1611590176,1611590181,132,19,6
mProject,ID0000163,10182.000.000,192.168.1.161,1611573418,1611584501,1611585633,1611585634,1611585634,1611585635,1611585640,11083,1133,6
mDiffFit,ID0000288,10466.000.000,192.168.1.161,1611589749,1611590044,1611590053,1611590056,1611590056,1611590056,1611590061,295,12,5
clean_up_local_level,0_5,10649.000.000,192.168.1.4,1611592488,1611592488,1611592505,1611592510,1611592510,1611592510,1611592516,0,22,6
mDiffFit,ID0000202,10333.000.000,192.168.1.161,1611585248,1611585647,1611585648,1611585658,1611585658,1611585659,1611585664,399,11,6
register_local,3_0,10314.000.000,192.168.1.4,1611584369,1611584374,1611584377,1611584380,1611584380,1611584380,1611584385,5,6,5
mDiffFit,ID0000362,10569.000.000,192.168.1.161,1611591880,1611591952,1611591963,1611591968,1611591968,1611591970,1611591975,72,16,7
clean_up_local_level,4_7,10673.000.000,192.168.1.4,1611592583,1611592589,1611592602,1611592604,1611592604,1611592607,1611592614,6,15,10
mDiffFit,ID0000047,10627.000.000,192.168.1.161,1611592357,1611592388,1611592392,1611592397,1611592397,1611592399,1611592404,31,9,7
mBackground,ID0000146,10662.000.000,192.168.1.161,1611592522,1611592577,1611592603,1611592604,1611592604,1611592608,1611592614,55,27,10
mBackground,ID0000147,10661.000.000,192.168.1.161,1611592516,1611592576,1611592604,1611592614,1611592614,1611592616,1611592626,60,38,12
mDiffFit,ID0000374,10568.000.000,192.168.1.161,1611591877,1611591943,1611591946,1611591946,1611591946,1611591946,1611591951,66,3,5
mDiffFit,ID0000223,10223.000.000,192.168.1.161,1611579359,1611579437,1611579438,1611579442,1611579442,1611579443,1611579451,78,5,9
mDiffFit,ID0000289,10459.000.000,192.168.1.161,1611589737,1611589986,1611589988,1611589990,1611589990,1611589991,1611589996,249,4,6
mDiffFit,ID0000108,10253.000.000,192.168.1.161,1611581247,1611581470,1611581471,1611581472,1611581472,1611581473,1611581478,223,2,6
mBackground,ID0000307,10547.000.000,192.168.1.161,1611591108,1611591228,1611591237,1611591242,1611591242,1611591242,1611591247,120,14,5
mDiffFit,ID0000067,10206.000.000,192.168.1.161,1611577225,1611577657,1611577658,1611577662,1611577662,1611577662,1611577667,432,5,5
mBackground,ID0000139,10663.000.000,192.168.1.161,1611592523,1611592606,1611592621,1611592626,1611592626,1611592627,1611592635,83,20,9
mDiffFit,ID0000260,10527.000.000,192.168.1.161,1611590907,1611591009,1611591016,1611591019,1611591019,1611591019,1611591024,102,10,5
mDiffFit,ID0000339,10428.000.000,192.168.1.161,1611588673,1611588738,1611588741,1611588743,1611588743,1611588744,1611588749,65,5,6
register_local,3_1,10648.000.000,192.168.1.4,1611592478,1611592482,1611592484,1611592489,1611592489,1611592489,1611592494,4,7,5
mAdd,ID0000313,10555.000.000,192.168.1.161,1611591351,1611591391,1611591418,1611591421,1611591421,1611591422,1611591426,40,30,5
mBackground,ID0000306,10548.000.000,192.168.1.161,1611591109,1611591240,1611591250,1611591252,1611591252,1611591253,1611591258,131,12,6
mDiffFit,ID0000051,10636.000.000,192.168.1.161,1611592371,1611592431,1611592432,1611592437,1611592437,1611592439,1611592445,60,6,8
mDiffFit,ID0000022,10474.000.000,192.168.1.161,1611589966,1611590094,1611590095,1611590098,1611590098,1611590100,1611590104,128,4,6
register_local,3_4,10692.000.000,192.168.1.4,1611592741,1611592743,1611592744,1611592747,1611592747,1611592748,1611592754,2,4,7
mDiffFit,ID0000438,10443.000.000,192.168.1.161,1611588701,1611588832,1611588840,1611588845,1611588845,1611588846,1611588853,131,13,8
clean_up_local_level,2_3,10403.000.000,192.168.1.4,1611588117,1611588117,1611588128,1611588131,1611588131,1611588131,1611588136,0,14,5
mDiffFit,ID0000195,10233.000.000,192.168.1.161,1611579451,1611579485,1611579487,1611579490,1611579490,1611579490,1611579495,34,5,5
mDiffFit,ID0000099,10475.000.000,192.168.1.161,1611589966,1611590094,1611590095,1611590098,1611590098,1611590099,1611590104,128,4,6
mDiffFit,ID0000023,10398.000.000,192.168.1.161,1611587001,1611587098,1611587100,1611587105,1611587105,1611587106,1611587111,97,7,6
clean_up_local_level,9_3,10327.000.000,192.168.1.4,1611585241,1611585242,1611585248,1611585249,1611585249,1611585249,1611585254,1,7,5
mImgtbl,ID0000469,10609.000.000,192.168.1.161,1611592195,1611592241,1611592247,1611592251,1611592251,1611592252,1611592257,46,10,6
mDiffFit,ID0000063,10291.000.000,192.168.1.161,1611582765,1611582906,1611582907,1611582907,1611582907,1611582908,1611582913,141,1,6
mBackground,ID0000466,10587.000.000,192.168.1.161,1611592046,1611592118,1611592136,1611592143,1611592143,1611592144,1611592152,72,25,9
mDiffFit,ID0000085,10360.000.000,192.168.1.161,1611586252,1611586299,1611586310,1611586311,1611586311,1611586311,1611586316,47,12,5
mProject,ID0000002,10165.000.000,192.168.1.161,1611573323,1611578144,1611579862,1611579866,1611579866,1611579866,1611579871,4821,1722,5
mDiffFit,ID0000215,10487.000.000,192.168.1.161,1611590024,1611590172,1611590176,1611590181,1611590181,1611590181,1611590186,148,9,5
mDiffFit,ID0000412,10326.000.000,192.168.1.161,1611584440,1611584501,1611584503,1611584505,1611584505,1611584505,1611584510,61,4,5
mProject,ID0000316,10152.000.000,192.168.1.161,1611573303,1611573316,1611574825,1611574828,1611574828,1611574828,1611574833,13,1512,5
mBackground,ID0000301,10544.000.000,192.168.1.161,1611591102,1611591189,1611591199,1611591200,1611591200,1611591200,1611591205,87,11,5
mDiffFit,ID0000213,10495.000.000,192.168.1.161,1611590043,1611590220,1611590225,1611590230,1611590230,1611590230,1611590235,177,10,5
mDiffFit,ID0000267,10389.000.000,192.168.1.161,1611586939,1611587053,1611587055,1611587060,1611587060,1611587062,1611587066,114,7,6
mDiffFit,ID0000352,10425.000.000,192.168.1.161,1611588667,1611588728,1611588730,1611588731,1611588731,1611588732,1611588737,61,3,6
mDiffFit,ID0000226,10268.000.000,192.168.1.161,1611582249,1611582385,1611582386,1611582389,1611582389,1611582389,1611582394,136,4,5
register_local,16_1,10574.000.000,192.168.1.4,1611591996,1611591996,1611591998,1611592002,1611592002,1611592002,1611592007,0,6,5
clean_up_local_level,4_3,10469.000.000,192.168.1.4,1611589959,1611589959,1611589970,1611589974,1611589974,1611589974,1611589979,0,15,5
mDiffFit,ID0000056,10630.000.000,192.168.1.161,1611592358,1611592409,1611592414,1611592418,1611592418,1611592419,1611592425,51,9,7
mDiffFit,ID0000443,10211.000.000,192.168.1.161,1611578118,1611578125,1611578130,1611578134,1611578134,1611578134,1611578139,7,9,5
mDiffFit,ID0000200,10231.000.000,192.168.1.161,1611579449,1611579475,1611579480,1611579484,1611579484,1611579485,1611579490,26,9,6
mDiffFit,ID0000118,10365.000.000,192.168.1.161,1611586259,1611586352,1611586358,1611586363,1611586363,1611586364,1611586368,93,11,5
mBackground,ID0000300,10546.000.000,192.168.1.161,1611591102,1611591214,1611591224,1611591226,1611591226,1611591227,1611591232,112,12,6
register_local,22_1,10573.000.000,192.168.1.4,1611591903,1611591904,1611591906,1611591909,1611591909,1611591909,1611591914,1,5,5
stage_in_local_local,3_0,10148.000.000,192.168.1.4,1611573097,1611573099,1611573291,1611573293,1611573293,1611573294,1611573298,2,194,5
mDiffFit,ID0000370,10320.000.000,192.168.1.161,1611584426,1611584464,1611584467,1611584468,1611584468,1611584469,1611584474,38,4,6
mDiffFit,ID0000381,10340.000.000,192.168.1.161,1611585595,1611585687,1611585689,1611585692,1611585692,1611585693,1611585698,92,5,6
mDiffFit,ID0000123,10227.000.000,192.168.1.161,1611579427,1611579454,1611579455,1611579456,1611579456,1611579457,1611579461,27,2,5
mAdd,ID0000156,10690.000.000,192.168.1.161,1611592708,1611592743,1611592764,1611592764,1611592764,1611592765,1611592769,35,21,5
mDiffFit,ID0000344,10433.000.000,192.168.1.161,1611588681,1611588768,1611588769,1611588771,1611588771,1611588771,1611588776,87,3,5
register_local,25_1,10534.000.000,192.168.1.4,1611590992,1611590992,1611590996,1611590997,1611590997,1611590998,1611591003,0,5,6
mDiffFit,ID0000211,10491.000.000,192.168.1.161,1611590033,1611590195,1611590198,1611590204,1611590204,1611590204,1611590209,162,9,5
mDiffFit,ID0000280,10456.000.000,192.168.1.161,1611589737,1611589965,1611589967,1611589967,1611589967,1611589967,1611589974,228,2,7
register_local,4_0,10631.000.000,192.168.1.4,1611592363,1611592363,1611592365,1611592376,1611592376,1611592378,1611592385,0,13,9
mDiffFit,ID0000017,10396.000.000,192.168.1.161,1611586993,1611587089,1611587105,1611587111,1611587111,1611587112,1611587116,96,22,5
mBackground,ID0000463,10579.000.000,192.168.1.161,1611592033,1611592065,1611592087,1611592088,1611592088,1611592088,1611592096,32,23,8
mDiffFit,ID0000276,10282.000.000,192.168.1.161,1611582648,1611582814,1611582823,1611582824,1611582824,1611582824,1611582829,166,10,5
mDiffFit,ID0000214,10489.000.000,192.168.1.161,1611590031,1611590183,1611590187,1611590192,1611590192,1611590193,1611590198,152,9,6
mProject,ID0000172,10173.000.000,192.168.1.161,1611573330,1611581133,1611582236,1611582238,1611582238,1611582238,1611582243,7803,1105,5
mDiffFit,ID0000045,10252.000.000,192.168.1.161,1611581247,1611581463,1611581464,1611581467,1611581467,1611581467,1611581472,216,4,5
mDiffFit,ID0000235,10458.000.000,192.168.1.161,1611589737,1611589980,1611589981,1611589985,1611589985,1611589985,1611589990,243,5,5
register_local,15_1,10677.000.000,192.168.1.4,1611592623,1611592625,1611592632,1611592635,1611592635,1611592638,1611592646,2,10,11
mDiffFit,ID0000368,10261.000.000,192.168.1.161,1611581445,1611581518,1611581519,1611581520,1611581520,1611581521,1611581526,73,2,6
mProject,ID0000317,10171.000.000,192.168.1.161,1611573329,1611579921,1611581430,1611581433,1611581433,1611581433,1611581438,6592,1512,5
mDiffFit,ID0000337,10430.000.000,192.168.1.161,1611588673,1611588749,1611588753,1611588755,1611588755,1611588756,1611588761,76,6,6
mDiffFit,ID0000110,10286.000.000,192.168.1.161,1611582759,1611582862,1611582864,1611582865,1611582865,1611582865,1611582870,103,3,5
mDiffFit,ID0000269,10468.000.000,192.168.1.161,1611589749,1611590051,1611590064,1611590066,1611590066,1611590066,1611590071,302,15,5
mDiffFit,ID0000244,10352.000.000,192.168.1.161,1611585653,1611585768,1611585771,1611585773,1611585773,1611585774,1611585779,115,5,6
mDiffFit,ID0000393,10322.000.000,192.168.1.161,1611584430,1611584475,1611584477,1611584479,1611584479,1611584479,1611584484,45,4,5
mDiffFit,ID0000270,10202.000.000,192.168.1.161,1611575961,1611576565,1611576571,1611576572,1611576572,1611576572,1611576577,604,7,5
clean_up_local_level,0_8,10688.000.000,192.168.1.4,1611592707,1611592707,1611592716,1611592718,1611592718,1611592719,1611592724,0,11,6
mDiffFit,ID0000375,10346.000.000,192.168.1.161,1611585602,1611585721,1611585730,1611585732,1611585732,1611585733,1611585738,119,11,6
mProject,ID0000009,10172.000.000,192.168.1.161,1611573330,1611580977,1611582744,1611582748,1611582748,1611582748,1611582753,7647,1771,5
mDiffFit,ID0000081,10313.000.000,192.168.1.161,1611584369,1611584431,1611584433,1611584440,1611584440,1611584440,1611584445,62,9,5
mDiffFit,ID0000185,10464.000.000,192.168.1.161,1611589743,1611590032,1611590034,1611590044,1611590044,1611590044,1611590051,289,12,7
mDiffFit,ID0000019,10400.000.000,192.168.1.161,1611587001,1611587109,1611587111,1611587111,1611587111,1611587112,1611587116,108,2,5
register_local,33_1,10619.000.000,192.168.1.4,1611592341,1611592341,1611592343,1611592346,1611592346,1611592347,1611592351,0,5,5
mDiffFit,ID0000265,10521.000.000,192.168.1.161,1611590901,1611590961,1611590963,1611590965,1611590965,1611590966,1611590971,60,4,6
mDiffFit,ID0000060,10210.000.000,192.168.1.161,1611577651,1611577689,1611577690,1611577693,1611577693,1611577694,1611577698,38,4,5
mDiffFit,ID0000191,10273.000.000,192.168.1.161,1611582357,1611582420,1611582426,1611582431,1611582431,1611582431,1611582436,63,11,5
register_local,0_2,10651.000.000,192.168.1.4,1611592494,1611592499,1611592500,1611592504,1611592504,1611592504,1611592510,5,5,6
mBackground,ID0000461,10581.000.000,192.168.1.161,1611592033,1611592070,1611592087,1611592088,1611592088,1611592088,1611592096,37,18,8
mDiffFit,ID0000367,10447.000.000,192.168.1.161,1611588709,1611588857,1611588858,1611588861,1611588861,1611588862,1611588867,148,4,6
mDiffFit,ID0000122,10599.000.000,192.168.1.161,1611592077,1611592208,1611592223,1611592229,1611592229,1611592230,1611592235,131,21,6
mDiffFit,ID0000247,10349.000.000,192.168.1.161,1611585647,1611585744,1611585746,1611585748,1611585748,1611585748,1611585753,97,4,5
register_local,4_1,10616.000.000,192.168.1.4,1611592308,1611592309,1611592311,1611592314,1611592314,1611592314,1611592319,1,5,5
mBackground,ID0000308,10552.000.000,192.168.1.161,1611591115,1611591293,1611591302,1611591305,1611591305,1611591305,1611591310,178,12,5
mDiffFit,ID0000057,10629.000.000,192.168.1.161,1611592357,1611592407,1611592412,1611592418,1611592418,1611592418,1611592425,50,11,7
mDiffFit,ID0000079,10308.000.000,192.168.1.161,1611584363,1611584369,1611584370,1611584375,1611584375,1611584375,1611584380,6,6,5
mDiffFit,ID0000048,10626.000.000,192.168.1.161,1611592357,1611592379,1611592391,1611592397,1611592397,1611592398,1611592404,22,18,7
mDiffFit,ID0000274,10280.000.000,192.168.1.161,1611582642,1611582799,1611582801,1611582803,1611582803,1611582803,1611582808,157,4,5
register_local,26_1,10645.000.000,192.168.1.4,1611592467,1611592468,1611592469,1611592473,1611592473,1611592473,1611592478,1,5,5
mDiffFit,ID0000278,10329.000.000,192.168.1.161,1611585242,1611585607,1611585608,1611585613,1611585613,1611585613,1611585618,365,6,5
mDiffFit,ID0000434,10244.000.000,192.168.1.161,1611581036,1611581077,1611581083,1611581086,1611581086,1611581086,1611581091,41,9,5
mDiffFit,ID0000246,10354.000.000,192.168.1.161,1611585656,1611585778,1611585780,1611585785,1611585785,1611585785,1611585790,122,7,5
mBackground,ID0000467,10584.000.000,192.168.1.161,1611592039,1611592095,1611592112,1611592116,1611592116,1611592117,1611592122,56,21,6
mDiffFit,ID0000062,10207.000.000,192.168.1.161,1611577225,1611577664,1611577670,1611577672,1611577672,1611577673,1611577678,439,8,6
mDiffFit,ID0000181,10377.000.000,192.168.1.161,1611586921,1611586977,1611586981,1611586983,1611586983,1611586984,1611586994,56,6,11
mDiffFit,ID0000109,10357.000.000,192.168.1.161,1611586251,1611586257,1611586267,1611586269,1611586269,1611586269,1611586274,6,12,5
mBackground,ID0000462,10580.000.000,192.168.1.161,1611592033,1611592065,1611592087,1611592088,1611592088,1611592088,1611592096,32,23,8
mDiffFit,ID0000386,10217.000.000,192.168.1.161,1611578184,1611578215,1611578217,1611578221,1611578221,1611578221,1611578226,31,6,5
mDiffFit,ID0000382,10338.000.000,192.168.1.161,1611585595,1611585674,1611585676,1611585680,1611585680,1611585682,1611585687,79,6,7
mDiffFit,ID0000186,10375.000.000,192.168.1.161,1611586915,1611586963,1611586967,1611586967,1611586967,1611586968,1611586972,48,4,5
mProject,ID0000165,10195.000.000,192.168.1.161,1611573476,1611589725,1611590881,1611590885,1611590885,1611590885,1611590890,16249,1160,5
register_local,5_1,10617.000.000,192.168.1.4,1611592319,1611592319,1611592321,1611592324,1611592324,1611592324,1611592330,0,5,6
mDiffFit,ID0000216,10275.000.000,192.168.1.161,1611582362,1611582439,1611582440,1611582441,1611582441,1611582441,1611582446,77,2,5
register_local,32_1,10680.000.000,192.168.1.4,1611592646,1611592647,1611592650,1611592652,1611592652,1611592654,1611592661,1,5,9
clean_up_local_level,6_3,10557.000.000,192.168.1.4,1611591862,1611591863,1611591874,1611591881,1611591881,1611591881,1611591891,1,18,10
register_local,7_1,10454.000.000,192.168.1.4,1611588909,1611588910,1611588911,1611588915,1611588915,1611588915,1611588920,1,5,5
mDiffFit,ID0000422,10506.000.000,192.168.1.161,1611590460,1611590496,1611590497,1611590500,1611590500,1611590501,1611590506,36,4,6
stage_in_local_local,1_0,10143.000.000,192.168.1.4,1611573090,1611573096,1611573301,1611573304,1611573304,1611573304,1611573310,6,208,6
mDiffFit,ID0000431,10247.000.000,192.168.1.161,1611581037,1611581112,1611581113,1611581116,1611581116,1611581116,1611581121,75,4,5
mDiffFit,ID0000037,10236.000.000,192.168.1.161,1611579877,1611579904,1611579906,1611579908,1611579908,1611579909,1611579914,27,4,6
